Struthio_camelus_australis	Ensembl
Casuarius_casuarius	NCBI
Dromaius_novaehollandiae	Ensembl
Gallus_gallus	Ensembl
Meleagris_gallopavo	Ensembl
Numida_meleagris	Ensembl
Penelope_pileata	NCBI
Alectura_lathami	NCBI
Anseranas_semipalmata	NCBI
Anas_platyrhynchos_playtyrhynchos	Ensembl
Anser_cygnoides	Ensembl
Balearica_regulorum	NCBI
Grus_americana	NCBI
Calidris_pugnax	Ensembl
Bucorvus_abyssinicus	NCBI
Buceros_rhinoceros	NCBI
Upupa_epops	NCBI
Rhinopomastus_cyanomelas	NCBI
Strix_occidentalis	Ensembl
Ficedula_albicollis	Ensembl
Anser_brachyrhynchus	Ensembl
Aquila_chrysaetos_chrysaetos	Ensembl
Geospiza_fortis	Ensembl
Parus_major	Ensembl
Serinus_canaria	Ensembl
Strigops_habroptila	Ensembl
Coturnix_japonica	Ensembl
